181,182,183,0,0,0,0,0,0,0,0
184,185,186,0,0,0,0,0,0,0,0
187,188,189,0,0,0,0,0,0,0,0
0,0,0,0,0,0,0,0,0,0,0
0,0,0,0,0,0,0,0,0,0,0
0,0,0,0,0,0,0,0,0,0,0
0,0,0,0,0,0,0,0,0,0,0
0,0,0,0,0,0,0,0,0,0,0
0,0,0,0,0,0,0,0,0,0,0
14,00,0,0,0,0,0,0,0,0,0
13,01,0,0,0,0,0,0,0,0,0