1, 20, 20, 20, 20, 13, 20, 20, 20, 20, 1
1, 20, 20, 20, 20, 01, 20, 20, 20, 20, 1
1, 20, 20, 20, 20, 0, 20, 20, 20, 20, 1
1, 20, 20, 20, 20, 0, 20, 20, 20, 20, 1
1, 20, 20, 20, 20, 71, 20, 20, 20, 20, 1
1, 20, 20, 20, 20, 0, 20, 20, 20, 20, 1
1, 1, 20, 20, 20, 0, 20, 20, 20, 1, 1
1, 1, 1, 1, 1, 0, 1, 1, 1, 1, 1
19, 1, 19, 1, 0, 2, 00, 14, 19, 1, 19
19, 19, 19, 19, 19, hero, 19, 19, 19, 19, 19
19, 19, 19, 19, 19, 22, 19, 19, 19, 19, 19