13, 01, 0, 0, 0, 0, 0, 0, 0, 0, 0
1, 1, 1, 1, 1, 1, 1, 1, 1, 1, 0
11, 0, 44, 2, 0, 1, 11, 6, 11, 1, 0
6, 44, 10, 1, 0, 1, 11, 6, 11, 1, 0
1, 2, 1, 1, 0, 1, 1, 1, 43, 1, 0
6, 45, 0, 1, 0, 2, 63, 40, 42, 1, 0
9, 0, 7, 1, 0, 1, 1, 1, 1, 1, 0
1, 2, 1, 1, 0, 0, 0, 0, 0, 0, 0
0, 45, 0, 1, 1, 4, 1, 1, 1, 2, 1
11, 12, 6, 1, 8, 00, 0, 1, 6, 46, 7
11, 34, 6, 1, 0, 14, 0, 1, 6, 6, 6