71, 41, 6, 1, 23, 22, 21, 1, 1, 1, 1
41, 6, 0, 1, 0, 0, 0, 1, 0, 42, 0
6, 44, 0, 1, 1, 2, 1, 1, 0, 1, 0
1, 2, 1, 1, 0, 44, 0, 1, 6, 1, 41
0, 0, 0, 1, 1, 1, 0, 1, 6, 1, 42
40, 1, 0, 42, 41, 42, 0, 1, 6, 1, 41
40, 1, 1, 1, 1, 1, 0, 0, 0, 1, 0
0, 0, 0, 0, 0, 1, 1, 2, 1, 1, 0
1, 1, 1, 1, 42, 1, 41, 0, 41, 1, 0
1, 0, 0, 0, 0, 1, 9, 42, 6, 1, 01
14, 00, 1, 1, 1, 1, 10, 12, 6, 1, 13