36, 1, 11, 1, 12, 63, 0, 0, 63, 6, 7
0, 1, 10, 1, 63, 0, 0, 0, 0, 63, 6
48, 1, 0, 1, 45, 0, 1, 1, 2, 1, 1
0, 2, 63, 1, 76, 45, 1, 0, 46, 45, 27
48, 1, 0, 1, 1, 1, 1, 0, 0, 0, 45
10, 1, 0, 0, 0, 42, 44, 0, 0, 0, 0
9, 1, 1, 43, 1, 1, 1, 1, 0, 0, 0
0, 26, 1, 43, 1, 0, 0, 0, 46, 47, 0
1, 1, 1, 42, 1, 2, 1, 3, 1, 2, 1
00, 0, 1, 0, 1, 42, 1, 9, 2, 01, 1
14, 0, 42, 0, 0, 0, 1, 6, 1, 13, 1