13, 01, 0, 0, 0, 0, 0, 0, 1, 1, 1
1, 1, 0, 49, 1, 3, 1, 56, 0, 1, 1
1, 0, 49, 9, 1, 50, 1, 10, 56, 0, 1
0, 0, 1, 1, 1, 15, 1, 1, 1, 0, 0
0, 0, 3, 50, 15, 32, 15, 50, 3, 0, 0
0, 1, 1, 1, 1, 15, 1, 1, 1, 1, 0
0, 1, 11, 10, 1, 50, 1, 9, 11, 1, 0
0, 1, 6, 11, 1, 3, 1, 11, 6, 1, 0
0, 1, 1, 7, 7, 12, 7, 7, 1, 1, 0
0, 0, 1, 1, 1, 4, 1, 1, 1, 0, 0
1, 0, 0, 2, 14, 00, 0, 2, 0, 0, 1