14, 1, 0, 0, 0, 0, 1, 0, 6, 56, 0
00, 1, 0, 1, 1, 2, 1, 2, 1, 1, 0
0, 1, 0, 1, 0, 0, 3, 0, 0, 1, 10
0, 1, 0, 1, 60, 1, 1, 1, 48, 1, 43
48, 1, 0, 1, 11, 1, 13, 01, 0, 1, 43
49, 1, 9, 1, 11, 1, 1, 1, 1, 1, 0
48, 1, 43, 1, 0, 0, 0, 1, 0, 49, 0
0, 1, 43, 1, 1, 1, 47, 1, 2, 1, 1
0, 1, 0, 56, 0, 1, 56, 1, 0, 0, 0
0, 1, 1, 1, 2, 1, 0, 1, 1, 1, 0
0, 0, 60, 0, 0, 1, 0, 51, 50, 51, 0